heifer - телка
vicar  - наместник
joust - рыцарский турнир
tow -  тащить
stout - крепкий
viscount - виконт
gouge - выдалбливать
clangour - бренчать
croquet - крокет
mallet - деревянный молоток
clover - клевер
chaise - фаэтон, почтовая карета
chalice - кубок, чаша
plough - плуг
heron - цапля
aerie - выводок
skein - моток пряжи, неразбериха
streak - полоса
corps  - корпус
crevice - расщелина
nob -  шишка
mover - двигатель
haunt - преследовать
anamone - анемон, ветреница
mica - слюда
lichen - лишайник, лишай
plait - заплетать, коса, складка
oath - присяга
ally - союзник, сообщник, помощник
comb - расческа
dough - тесто, паста
gauze - марля, газ
sieve - сито, решето
?
?
bosom - грудь, лоно, недра
chalet - шале, коттедж
leech - пиявка
laurel - лавры, почести
verging - граничащий
gauge - калибр
plaque - бляшка, металлический диск
groat - мелкая сумма
dost - дост
doth - рассудить
succour - помогать
ere - прежде чем
sedate - спокойный
petal - лепесток
lice - вши
devoid - лишённый,свободный
zeal - рвение, усердие
viscous - вязкий, тягучий, липкий
spiky - колючий 
deafer - глуховатый, отказывающийся слушать
ague - лихорадка, малярия
mauve - розовато - лиловый
foul - нарушение правил
wont - привычка
folige - листва
loth - несколнный, нежелающий
aye - всегда, постоянно, да
privy - конфиденциальный, тайный, частный
breaches - нарушение, брешь, разрыв
grits - овсяная крупа
cloven - раздвоенный, расколотый
wits - ум
transom - транец, фрамуга
trikery - обман, хитрость
exiled - изгнание, ссылка
phlegm - мокрота, слизь, флегма
gunwale - фальшборт ограждение по краям наружной палубы судна, корабля или другого плавучего средства представляющее собой сплошную стенку без вырезов или со специальными вырезами для стока воды 
sward - дёрн, покров, разон
whay - сыворотка
enamored - влюблённый
plague - чума, мор, бедствие, досаждать
scour - рыскать, оттирать, чистить, прочёсывать
revile - поносить, оскорблять, ругать
devour - пожирать, истреблять
efface - стирать, вычёркивать
grieve -  горевать
indiet  - обвинить
hallowed - святиться, чтить
heave - подъем
cleanse - очищать
vow - клятва
aver - кляча, утверждать
linger - задерживаться, медлить

57. leech
58. mauve
60. trick - но это не точно